111111111111
1b00000000001
100000P10001
100C000000B11
1B30000000B21
111111110111