
1111111111111
1           1
1           1 
1           1
1           1
1           1
1p00000000001
100000C000001
10B"1"(1 )0000C0000001
100000C0@( )0001
1111111111111