111111111111
1b000C0000001
1000C0010001
100P0C0000B11
1B30000000B21
111111110111