
1111111111111
1p0000000@( )001
1000000000001
1000000000001
1000000000001
1111111111111