111111111111
1b00000000001
100000000001
100000P000B11
1B30000000CB21
111111110111