
1111111111111
1           1
1           1 
1           1
1           1
1           1
1p0000000@( )01
100000C000001
1000000000001
100000C000001
1111111111111