111111111111
100000000001
100000000C01
10000P000001
100000000001
111111111111