1111111111111
1000000000001
1P00000100001
1b"1"(1)000CC00000001
10000@(1)0000001
1111111111111