111111111111
1b00000000001
100000000001
1000000000B11
1B30000P00CB21
111111110111