1111111111111
1000000000001
1P00000100001
10000CC000001
10000@(1 2 )00b"2"(1 )b"2"(2 )001
1111111111111