111111111111
100000000001
100000000C01
10000P000001
10000000B1001
111111110111