[:0:0:0:0][:0:0:1:0][:0:0:0:0][:0:0:1:0][:0:0:0:0][:0:0:1:0][:0:0:0:0]
[:0:0:0:0][:0:0:0:0][:0:0:0:0][:0:0:0:0][:0:0:0:0][:0:0:0:0][:0:0:0:0]
[:0:0:1:0][:0:0:0:0][:0:0:1:0][:0:0:0:0][:0:0:1:0][:0:0:0:0][:0:0:1:0]
[:0:0:0:0][:0:0:@:0][:0:0:b:0][:0:0:p:0][:0:0:c:0][:0:0:0:0][:0:0:0:0]
[:0:0:1:0][:0:0:1:0][:0:0:1:0][:0:0:1:0][:0:0:1:0][:0:0:1:0][:0:0:1:0]