11111111111111111111
10000000000000000001
10000000000000000001
10000000000000000001
100@()00c0000000000001
11111110000000000001
11111111000000000001
11111111100000000001
11111111110000000001
11111111111000000001
11111111111100000001
1000000000000000b"2"(2 )001
10000000000000111111
10000000000001111111
10000000000011111111
10000000000111111111
10000000001111111111
10pcb"2"(1 )000011111111111
11111111111111111111
11111111111111111111