00000000000000000000
00000000000000000000
00000000000000000000
00000000000000000000
00000001111110000000
00011110000000111000
00010000000000001000
00010000000000001000
00010000000000@(1 2 )01000
00010000000011111000
00010000000000001000
00010000000000001000
00010000000000001000
00010000000000001000
00010b"2"(1 )c0p0cb"2"(2 )00001000
00011111111111111000
00000000000000000000
00000000000000000000
00000000000000000000
00000000000000000000