000000000000000000000000
000000000000000000000000
000000000000000000000000
000000000000cc0000000000
0000000000000000c0000000
0000000000000000c0000000
00000000c000000000000000
000000000000c00000000000
000000000000000c00000000
0000000000b0000000000000
00111000p000@00000111100
000111111111111111000011
000000011011110110000011
000000000011111110011100
