0000000000000000
0000000000000000
0000000000000000
0000000000000000
000pc0b@00000000
1111111111111000
